# width height
15 15

# matrix
000000000100000
005555500000000
100200004000000
003202004000000
003002004000000
003000004000000
033300000000000
100001022000000
044440100000000
022000033300000
000000000000000
000000000000000
000000000000000
000000000000000
000000000000000
000000000000000

# number of boats of each size
1 5
2 4
3 3
4 2
5 1